BBBBBBBBBBBBB
B  S        B
B  E        B
B           B
B           B
B           B
B           B
B           B
B           B
B           B
B   P       B
B           B
BBBBBBBBBBBBB